á,s,a,$,V,IPFV,AGFOC	u,m,a,á,s,a
á,s,a,$,V,PFV,AGFOC	u,m,á,s,a
á,s,a,$,V,PFOC,LGSPEC1	a,á,s,a,h,a,n
á,s,a,$,V,NFIN	á,s,a
á,s,a,$,V,AGFOC,LGSPEC1	a,á,s,a
á,s,a,$,V,PFV,PFOC	i,n,á,s,a,h,a,n
á,s,a,$,V,IPFV,PFOC	i,n,a,á,s,a,h,a,n
l,í,t,o,$,V,PFV,AGFOC	n,a,l,í,t,o
l,í,t,o,$,V,PFOC,LGSPEC1	l,i,l,i,t,u,h,i,n
l,í,t,o,$,V,PFV,PFOC	n,i,l,í,t,o
l,í,t,o,$,V,AGFOC,LGSPEC1	m,a,l,i,l,í,t,o
l,í,t,o,$,V,NFIN	l,í,t,o
l,í,t,o,$,V,IPFV,AGFOC	n,a,l,i,l,í,t,o
l,í,t,o,$,V,IPFV,PFOC	n,i,l,i,l,í,t,o
b,a,l,i,t,a,$,V,PFOC,LGSPEC1	i,b,a,b,a,l,i,t,a
b,a,l,i,t,a,$,V,PFV,AGFOC	n,a,g,b,a,l,i,t,a
b,a,l,i,t,a,$,V,PFV,PFOC	b,i,n,a,l,i,t,a
b,a,l,i,t,a,$,V,IPFV,PFOC	b,i,n,a,b,a,l,i,t,a
b,a,l,i,t,a,$,V,NFIN	b,a,l,i,t,a
b,a,l,i,t,a,$,V,AGFOC,LGSPEC1	m,a,g,b,a,b,a,l,i,t,a
b,a,l,i,t,a,$,V,IPFV,AGFOC	n,a,g,b,a,b,a,l,i,t,a
g,u,h,i,t,$,V,PFOC,LGSPEC1	g,u,g,u,h,i,t,i,n
g,u,h,i,t,$,V,AGFOC,LGSPEC1	m,a,g,g,u,g,u,h,i,t
g,u,h,i,t,$,V,PFV,PFOC	g,i,n,u,h,i,t
g,u,h,i,t,$,V,IPFV,PFOC	g,i,n,u,g,u,h,i,t
g,u,h,i,t,$,V,PFV,AGFOC	n,a,g,g,u,h,i,t
g,u,h,i,t,$,V,NFIN	g,u,h,i,t
g,u,h,i,t,$,V,IPFV,AGFOC	n,a,g,g,u,g,u,h,i,t
m,á,s,i,d,$,V,PFV,PFOC	m,i,n,á,s,d,a,n
m,á,s,i,d,$,V,AGFOC,LGSPEC1	m,a,g,m,a,m,á,s,i,d
m,á,s,i,d,$,V,IPFV,AGFOC	n,a,g,m,a,m,á,s,i,d
m,á,s,i,d,$,V,NFIN	m,á,s,i,d
m,á,s,i,d,$,V,IPFV,PFOC	m,i,n,a,m,á,s,d,a,n
m,á,s,i,d,$,V,PFOC,LGSPEC1	m,a,m,á,s,d,a,n
m,á,s,i,d,$,V,PFV,AGFOC	n,a,g,m,á,s,i,d
s,u,r,i,',$,V,IPFV,PFOC	s,i,n,u,s,u,r,i,'
s,u,r,i,',$,V,PFOC,LGSPEC1	s,u,s,u,r,i,i,n
s,u,r,i,',$,V,AGFOC,LGSPEC1	m,a,g,s,u,s,u,r,i,'
s,u,r,i,',$,V,NFIN	s,u,r,i,'
s,u,r,i,',$,V,PFV,PFOC	s,i,n,u,r,i,'
s,u,r,i,',$,V,IPFV,AGFOC	n,a,g,s,u,s,u,r,i,'
s,u,r,i,',$,V,PFV,AGFOC	n,a,g,s,u,r,i,'
t,á,a,s,$,V,IPFV,AGFOC	n,a,g,t,a,t,á,a,s
t,á,a,s,$,V,NFIN	t,á,a,s
t,á,a,s,$,V,AGFOC,LGSPEC1	m,a,g,t,a,t,á,a,s
t,á,a,s,$,V,PFOC,LGSPEC1	t,a,t,á,a,s,i,n
t,á,a,s,$,V,PFV,AGFOC	n,a,g,t,á,a,s
t,á,a,s,$,V,PFV,PFOC	t,i,n,á,a,s
t,á,a,s,$,V,IPFV,PFOC	t,i,n,a,t,á,a,s
o,k,u,p,á,$,V,IPFV,PFOC	i,n,o,o,k,u,p,á
o,k,u,p,á,$,V,NFIN	o,k,u,p,á
o,k,u,p,á,$,V,PFV,AGFOC	n,a,g,-,o,k,u,p,á
o,k,u,p,á,$,V,PFOC,LGSPEC1	o,o,k,u,p,á,h,i,n
o,k,u,p,á,$,V,PFV,PFOC	i,n,o,k,u,p,á
o,k,u,p,á,$,V,AGFOC,LGSPEC1	m,a,g,-,o,o,k,u,p,á
o,k,u,p,á,$,V,IPFV,AGFOC	n,a,g,-,o,o,k,u,p,á
a,n,a,k,$,V,PFOC,LGSPEC1	i,p,a,p,a,n,g,a,n,a,k
a,n,a,k,$,V,IPFV,AGFOC	n,a,n,g,a,n,g,a,n,a,k
a,n,a,k,$,V,PFV,PFOC	i,p,i,n,a,n,g,a,n,a,k
a,n,a,k,$,V,PFV,AGFOC	n,a,n,g,a,n,a,k
a,n,a,k,$,V,NFIN	a,n,a,k
a,n,a,k,$,V,AGFOC,LGSPEC1	m,a,n,g,a,n,g,a,n,a,k
a,n,a,k,$,V,IPFV,PFOC	p,i,n,a,p,a,n,g,a,n,a,k
b,i,t,b,i,t,$,V,NFIN	b,i,t,b,i,t
b,i,t,b,i,t,$,V,PFV,PFOC	b,i,n,i,t,b,i,t
b,i,t,b,i,t,$,V,AGFOC,LGSPEC1	m,a,g,b,i,b,i,t,b,i,t
b,i,t,b,i,t,$,V,PFV,AGFOC	n,a,g,b,i,t,b,i,t
b,i,t,b,i,t,$,V,IPFV,PFOC	b,i,n,i,b,i,t,b,i,t
b,i,t,b,i,t,$,V,PFOC,LGSPEC1	b,i,b,i,t,b,i,t,i,n
b,i,t,b,i,t,$,V,IPFV,AGFOC	n,a,g,b,i,b,i,t,b,i,t
p,a,a,l,a,m,$,V,AGFOC,LGSPEC1	m,a,g,p,a,p,a,a,l,a,m
p,a,a,l,a,m,$,V,PFV,AGFOC	n,a,g,p,a,a,l,a,m
p,a,a,l,a,m,$,V,NFIN	p,a,a,l,a,m
p,a,a,l,a,m,$,V,IPFV,AGFOC	n,a,g,p,a,p,a,a,l,a,m
t,a,l,o,n,$,V,AGFOC,LGSPEC1	t,a,t,a,l,o,n
t,a,l,o,n,$,V,IPFV,PFOC	t,i,n,a,t,a,l,o,n
t,a,l,o,n,$,V,PFV,AGFOC	t,u,m,a,l,o,n
t,a,l,o,n,$,V,NFIN	t,a,l,o,n
t,a,l,o,n,$,V,PFV,PFOC	t,i,n,a,l,o,n
t,a,l,o,n,$,V,IPFV,AGFOC	t,u,m,a,t,a,l,o,n
t,a,l,o,n,$,V,PFOC,LGSPEC1	t,a,t,a,l,u,n,i,n
p,l,a,n,t,s,a,$,V,IPFV,AGFOC	n,a,g,p,a,p,l,a,n,t,s,a
p,l,a,n,t,s,a,$,V,NFIN	p,l,a,n,t,s,a
p,l,a,n,t,s,a,$,V,PFV,AGFOC	n,a,g,p,l,a,n,t,s,a
p,l,a,n,t,s,a,$,V,PFOC,LGSPEC1	p,a,p,l,a,n,t,s,a,h,i,n
p,l,a,n,t,s,a,$,V,AGFOC,LGSPEC1	m,a,g,p,l,a,p,l,a,n,t,s,a
p,l,a,n,t,s,a,$,V,IPFV,PFOC	p,i,n,a,p,l,a,n,t,s,a
p,l,a,n,t,s,a,$,V,PFV,PFOC	p,i,n,a,l,t,s,a
h,í,l,o,$,V,PFV,AGFOC	n,a,h,í,l,o
h,í,l,o,$,V,AGFOC,LGSPEC1	m,a,h,i,h,í,l,o
h,í,l,o,$,V,IPFV,AGFOC	n,a,h,i,h,í,l,o
h,í,l,o,$,V,NFIN	h,í,l,o
s,a,y,a,w,$,V,IPFV,AGFOC	s,u,m,a,s,a,y,a,w
s,a,y,a,w,$,V,PFV,PFOC	s,i,n,a,y,a,w
s,a,y,a,w,$,V,AGFOC,LGSPEC1	s,a,s,a,y,a,w
s,a,y,a,w,$,V,NFIN	s,a,y,a,w
s,a,y,a,w,$,V,PFOC,LGSPEC1	s,a,s,a,y,a,w,i,n
s,a,y,a,w,$,V,IPFV,PFOC	s,i,n,a,s,a,y,a,w
s,a,y,a,w,$,V,PFV,AGFOC	s,u,m,a,y,a,w
s,á,k,i,t,$,V,IPFV,AGFOC	s,u,m,a,s,á,k,i,t
s,á,k,i,t,$,V,PFV,AGFOC	n,a,s,á,k,t,a,n
s,á,k,i,t,$,V,AGFOC,LGSPEC1	s,a,s,á,k,i,t
s,á,k,i,t,$,V,PFV,PFOC	s,i,n,á,k,t,a,n
s,á,k,i,t,$,V,PFOC,LGSPEC1	s,a,s,á,k,t,a,n
s,á,k,i,t,$,V,NFIN	s,á,k,i,t
s,á,k,i,t,$,V,IPFV,PFOC	s,i,n,a,s,á,k,t,a,n
s,a,r,á,$,V,NFIN	s,a,r,á
s,a,r,á,$,V,PFOC,LGSPEC1	i,s,a,s,a,r,á
s,a,r,á,$,V,PFV,AGFOC	n,a,g,s,a,r,á
s,a,r,á,$,V,AGFOC,LGSPEC1	m,a,g,s,a,s,a,r,á
s,a,r,á,$,V,IPFV,PFOC	s,i,n,a,s,a,r,á
s,a,r,á,$,V,PFV,PFOC	s,i,n,a,r,á
s,a,r,á,$,V,IPFV,AGFOC	n,a,g,s,a,s,a,r,á
d,a,t,i,n,g, ,r,a,t,i,n,g,$,V,IPFV,AGFOC	d,u,m,a,r,a,t,i,n,g, ,n,a,r,a,r,a,t,i,n,g
d,a,t,i,n,g, ,r,a,t,i,n,g,$,V,AGFOC,LGSPEC1	d,a,r,a,t,i,n,g, ,m,a,r,a,r,a,t,i,n,g
d,a,t,i,n,g, ,r,a,t,i,n,g,$,V,NFIN	d,a,t,i,n,g, ,r,a,t,i,n,g
d,a,t,i,n,g, ,r,a,t,i,n,g,$,V,PFV,AGFOC	d,u,m,a,t,i,n,g, ,n,a,r,a,t,i,n,g
a,l,a,g,a,',$,V,IPFV,PFOC	i,n,a,a,l,a,g,a,a,n
a,l,a,g,a,',$,V,PFV,AGFOC	n,a,g,-,a,l,a,g,a,'
a,l,a,g,a,',$,V,PFV,PFOC	i,n,a,l,a,g,a,a,n
a,l,a,g,a,',$,V,IPFV,AGFOC	n,a,g,-,a,a,l,a,g,a,'
a,l,a,g,a,',$,V,NFIN	a,l,a,g,a,'
a,l,a,g,a,',$,V,AGFOC,LGSPEC1	m,a,g,-,a,a,l,a,g,a,'
a,l,a,g,a,',$,V,PFOC,LGSPEC1	a,a,l,a,g,a,a,n
i,n,i,s,$,V,PFV,PFOC	i,n,i,n,i,s
i,n,i,s,$,V,IPFV,AGFOC	n,a,n,g,-,i,i,n,i,s
i,n,i,s,$,V,PFV,AGFOC	n,a,n,g,-,i,n,i,s
i,n,i,s,$,V,PFOC,LGSPEC1	i,i,n,i,s,i,n
i,n,i,s,$,V,IPFV,PFOC	i,n,i,i,n,i,s
i,n,i,s,$,V,AGFOC,LGSPEC1	m,a,n,g,-,i,i,n,i,s
i,n,i,s,$,V,NFIN	i,n,i,s
l,a,b,a,s,$,V,AGFOC,LGSPEC1	m,a,g,l,a,l,a,b,a,s
l,a,b,a,s,$,V,PFOC,LGSPEC1	i,l,a,l,a,b,a,s
l,a,b,a,s,$,V,PFV,PFOC	n,i,l,a,b,a,s
l,a,b,a,s,$,V,NFIN	l,a,b,a,s
l,a,b,a,s,$,V,PFV,AGFOC	l,u,m,a,b,a,s
l,a,b,a,s,$,V,IPFV,AGFOC	l,u,m,a,l,a,b,a,s
l,a,b,a,s,$,V,IPFV,PFOC	n,i,l,a,l,a,b,a,s
l,a,b,a,s,$,V,PFV,AGFOC	n,a,g,l,a,b,a,s
s,a,g,o,t,$,V,NFIN	s,a,g,o,t
s,a,g,o,t,$,V,PFOC,LGSPEC1	s,a,s,a,g,u,t,i,n
s,a,g,o,t,$,V,AGFOC,LGSPEC1	s,a,s,a,g,o,t
s,a,g,o,t,$,V,PFV,PFOC	s,i,n,a,g,o,t
s,a,g,o,t,$,V,IPFV,PFOC	s,i,n,a,s,a,g,o,t
s,a,g,o,t,$,V,PFV,AGFOC	s,u,m,a,g,o,t
s,a,g,o,t,$,V,IPFV,AGFOC	s,u,m,a,s,a,g,o,t
l,a,g,a,y,$,V,IPFV,PFOC	n,i,l,a,l,a,g,a,y
l,a,g,a,y,$,V,PFV,PFOC	n,i,l,a,g,a,y
l,a,g,a,y,$,V,PFOC,LGSPEC1	i,l,a,l,a,g,a,y
l,a,g,a,y,$,V,IPFV,AGFOC	n,a,g,l,a,l,a,g,a,y
l,a,g,a,y,$,V,AGFOC,LGSPEC1	m,a,g,l,a,l,a,g,a,y
l,a,g,a,y,$,V,NFIN	l,a,g,a,y
l,a,g,a,y,$,V,PFV,AGFOC	n,a,g,l,a,g,a,y
i,b,i,g,$,V,PFV,AGFOC	u,m,i,b,i,g
i,b,i,g,$,V,AGFOC,LGSPEC1	i,i,b,i,g
i,b,i,g,$,V,NFIN	i,b,i,g
i,b,i,g,$,V,IPFV,PFOC	i,n,i,i,b,i,g
i,b,i,g,$,V,IPFV,AGFOC	u,m,i,i,b,i,g
i,b,i,g,$,V,PFOC,LGSPEC1	i,i,b,i,g,i,n
i,b,i,g,$,V,PFV,PFOC	i,n,i,b,i,g
s,i,e,s,t,a,$,V,IPFV,AGFOC	n,a,g,s,i,s,i,e,s,t,a
s,i,e,s,t,a,$,V,AGFOC,LGSPEC1	m,a,g,s,i,s,i,e,s,t,a
s,i,e,s,t,a,$,V,NFIN	s,i,e,s,t,a
s,i,e,s,t,a,$,V,PFV,AGFOC	n,a,g,s,i,e,s,t,a
p,a,l,a,k,p,a,k,$,V,IPFV,AGFOC	p,u,m,a,p,a,l,a,k,p,a,k
p,a,l,a,k,p,a,k,$,V,PFOC,LGSPEC1	p,a,p,a,l,a,k,p,a,k,a,n
p,a,l,a,k,p,a,k,$,V,NFIN	p,a,l,a,k,p,a,k
p,a,l,a,k,p,a,k,$,V,IPFV,PFOC	p,i,n,a,p,a,l,a,k,p,a,k,a,n
p,a,l,a,k,p,a,k,$,V,PFV,AGFOC	p,u,m,a,l,a,k,p,a,k
p,a,l,a,k,p,a,k,$,V,PFV,PFOC	p,i,n,a,l,a,k,p,a,k,a,n
p,a,l,a,k,p,a,k,$,V,AGFOC,LGSPEC1	p,a,p,a,l,a,k,p,a,k
ú,t,o,t,$,V,IPFV,AGFOC	u,m,u,ú,t,o,t
ú,t,o,t,$,V,AGFOC,LGSPEC1	u,ú,t,o,t
ú,t,o,t,$,V,PFV,AGFOC	u,m,ú,t,o,t
ú,t,o,t,$,V,IPFV,PFOC	i,n,u,ú,t,o,t
ú,t,o,t,$,V,PFOC,LGSPEC1	u,ú,t,u,t,i,n
ú,t,o,t,$,V,NFIN	ú,t,o,t
ú,t,o,t,$,V,PFV,PFOC	i,n,ú,t,o,t
s,a,l,i,t,a,',$,V,IPFV,PFOC	s,i,n,a,s,a,l,i,t,a,'
s,a,l,i,t,a,',$,V,PFV,PFOC	s,i,n,a,l,i,t,a,'
s,a,l,i,t,a,',$,V,AGFOC,LGSPEC1	m,a,g,s,a,s,a,l,i,t,a,'
s,a,l,i,t,a,',$,V,PFOC,LGSPEC1	s,a,s,a,l,i,t,a,i,n
s,a,l,i,t,a,',$,V,PFV,AGFOC	n,a,g,s,a,l,i,t,a,'
s,a,l,i,t,a,',$,V,IPFV,AGFOC	n,a,g,s,a,s,a,l,i,t,a,'
s,a,l,i,t,a,',$,V,NFIN	s,a,l,i,t,a,'
d,a,m,d,á,m,$,V,NFIN	d,a,m,d,á,m
d,a,m,d,á,m,$,V,PFV,AGFOC	n,a,g,d,a,m,d,á,m
d,a,m,d,á,m,$,V,AGFOC,LGSPEC1	m,a,g,d,a,r,a,m,d,á,m
d,a,m,d,á,m,$,V,IPFV,AGFOC	n,a,g,d,a,r,a,m,d,á,m
d,a,m,d,á,m,$,V,PFV,PFOC	d,i,n,a,m,d,á,m
d,a,m,d,á,m,$,V,PFOC,LGSPEC1	d,a,r,a,m,d,á,m,i,n
d,a,m,d,á,m,$,V,IPFV,PFOC	d,i,n,a,r,a,m,d,á,m
t,a,t,a,d,$,V,PFV,PFOC	t,i,n,a,d,t,a,d
t,a,t,a,d,$,V,PFOC,LGSPEC1	t,a,t,a,d,t,a,r,i,n
t,a,t,a,d,$,V,IPFV,PFOC	t,i,n,a,t,a,d,t,a,d
t,a,t,a,d,$,V,NFIN	t,a,t,a,d
t,a,t,a,d,$,V,PFV,AGFOC	n,a,g,t,a,d,t,a,d
t,a,t,a,d,$,V,AGFOC,LGSPEC1	m,a,g,t,a,t,a,d,t,a,d
t,a,t,a,d,$,V,IPFV,AGFOC	n,a,g,t,a,t,a,d,t,a,d
t,a,n,i,m,$,V,IPFV,AGFOC	n,a,g,t,a,t,a,n,i,m
t,a,n,i,m,$,V,NFIN	t,a,n,i,m
t,a,n,i,m,$,V,PFV,AGFOC	n,a,g,t,a,n,i,m
t,a,n,i,m,$,V,AGFOC,LGSPEC1	m,a,g,t,a,t,a,n,i,m
t,a,n,i,m,$,V,PFV,PFOC	t,i,n,a,n,i,m
t,a,n,i,m,$,V,IPFV,PFOC	t,i,n,a,t,a,n,i,m
t,a,n,i,m,$,V,PFOC,LGSPEC1	i,t,a,t,a,n,i,m
k,i,n,i,g,$,V,PFV,PFOC	p,i,n,a,k,i,n,g,g,a,n
k,i,n,i,g,$,V,AGFOC,LGSPEC1	m,a,k,i,k,i,n,i,g
k,i,n,i,g,$,V,PFV,AGFOC	n,a,k,i,n,i,g
k,i,n,i,g,$,V,PFOC,LGSPEC1	p,a,p,a,k,i,n,g,g,a,n
k,i,n,i,g,$,V,NFIN	k,i,n,i,g
k,i,n,i,g,$,V,IPFV,AGFOC	n,a,k,i,k,i,n,i,g
k,i,n,i,g,$,V,IPFV,PFOC	p,i,n,a,p,a,k,i,n,g,g,a,n
d,í,n,i,g,$,V,IPFV,AGFOC	n,a,d,i,d,i,n,i,g, ,n,a,r,i,r,i,n,i,g
d,í,n,i,g,$,V,AGFOC,LGSPEC1	m,a,d,i,d,i,n,i,g, ,m,a,r,i,r,i,n,i,g
d,í,n,i,g,$,V,NFIN	d,í,n,i,g
d,í,n,i,g,$,V,PFV,PFOC	d,i,n,i,n,i,g, ,d,i,n,i,r,i,g
d,í,n,i,g,$,V,PFV,AGFOC	n,a,d,i,n,i,g, ,n,a,r,i,n,i,g
d,í,n,i,g,$,V,PFOC,LGSPEC1	d,i,d,i,n,g,g,i,n, ,d,i,r,i,n,g,i,n,g,g,i,n
d,í,n,i,g,$,V,IPFV,PFOC	d,i,n,i,d,i,n,i,g, ,d,i,n,i,r,i,n,i,g
p,a,t,u,l,o,y,$,V,IPFV,AGFOC	n,a,g,p,a,p,a,t,u,l,o,y
p,a,t,u,l,o,y,$,V,PFV,AGFOC	n,a,g,p,a,t,u,l,o,y
p,a,t,u,l,o,y,$,V,NFIN	p,a,t,u,l,o,y
p,a,t,u,l,o,y,$,V,AGFOC,LGSPEC1	m,a,g,p,a,p,a,t,u,l,o,y
h,a,n,a,p,$,V,AGFOC,LGSPEC1	h,a,h,a,n,a,p
h,a,n,a,p,$,V,IPFV,AGFOC	h,u,m,a,h,a,n,a,p
h,a,n,a,p,$,V,PFOC,LGSPEC1	h,a,h,a,n,a,p,i,n
h,a,n,a,p,$,V,NFIN	h,a,n,a,p
h,a,n,a,p,$,V,IPFV,PFOC	h,i,n,a,h,a,n,a,p
h,a,n,a,p,$,V,PFV,AGFOC	h,u,m,a,n,a,p
h,a,n,a,p,$,V,PFV,PFOC	h,i,n,a,n,a,p
p,r,o,m,o,t,e,$,V,NFIN	p,r,o,m,o,t,e
p,r,o,m,o,t,e,$,V,PFOC,LGSPEC1	i,p,o,p,r,o,m,o,t,e
p,r,o,m,o,t,e,$,V,AGFOC,LGSPEC1	m,a,p,o,-,p,r,o,m,o,t,e
p,r,o,m,o,t,e,$,V,PFV,PFOC	p,i,n,r,o,m,o,t,e
p,r,o,m,o,t,e,$,V,IPFV,PFOC	p,i,n,o,p,r,o,m,o,t,e
p,r,o,m,o,t,e,$,V,PFV,AGFOC	n,a,-,p,r,o,m,o,t,e
p,r,o,m,o,t,e,$,V,IPFV,AGFOC	n,a,p,o,-,p,r,o,m,o,t,e
s,u,n,t,o,k,$,V,IPFV,AGFOC	n,a,n,u,n,u,n,t,o,k
s,u,n,t,o,k,$,V,NFIN	s,u,n,t,o,k
s,u,n,t,o,k,$,V,PFOC,LGSPEC1	s,u,s,u,n,t,u,k,i,n
s,u,n,t,o,k,$,V,IPFV,PFOC	s,i,n,u,s,u,n,t,o,k
s,u,n,t,o,k,$,V,PFV,PFOC	s,i,n,u,n,t,o,k
s,u,n,t,o,k,$,V,PFV,AGFOC	n,a,n,u,n,t,o,k
s,u,n,t,o,k,$,V,AGFOC,LGSPEC1	m,a,n,u,n,u,n,t,o,k
a,y,o,s,$,V,PFOC,LGSPEC1	a,a,y,u,s,i,n
a,y,o,s,$,V,PFV,AGFOC	n,a,g,-,a,y,o,s
a,y,o,s,$,V,AGFOC,LGSPEC1	m,a,g,-,a,a,y,o,s
a,y,o,s,$,V,NFIN	a,y,o,s
a,y,o,s,$,V,IPFV,AGFOC	n,a,g,-,a,a,y,o,s
a,y,o,s,$,V,IPFV,PFOC	i,n,a,a,y,o,s
a,y,o,s,$,V,PFV,PFOC	i,n,a,y,o,s
i,y,a,k,$,V,AGFOC,LGSPEC1	i,i,y,a,k
i,y,a,k,$,V,IPFV,AGFOC	u,m,i,i,y,a,k
i,y,a,k,$,V,PFV,AGFOC	u,m,i,y,a,k
i,y,a,k,$,V,PFOC,LGSPEC1	i,i,y,a,k,a,n
i,y,a,k,$,V,NFIN	i,y,a,k
i,y,a,k,$,V,PFV,PFOC	i,n,i,y,a,k,a,n
i,y,a,k,$,V,IPFV,PFOC	i,n,i,i,y,a,k,a,n
l,a,r,ó,',$,V,IPFV,AGFOC	n,a,g,l,a,l,a,r,ó,'
l,a,r,ó,',$,V,IPFV,PFOC	n,i,l,a,l,a,r,ó,'
l,a,r,ó,',$,V,PFOC,LGSPEC1	l,a,l,a,r,ú,i,n
l,a,r,ó,',$,V,NFIN	l,a,r,ó,'
l,a,r,ó,',$,V,PFV,AGFOC	n,a,g,l,a,g,r,ó,'
l,a,r,ó,',$,V,AGFOC,LGSPEC1	m,a,g,l,a,l,a,r,ó,'
l,a,r,ó,',$,V,PFV,PFOC	n,i,l,a,r,ó,'
t,i,n,g,í,n,$,V,NFIN	t,i,n,g,í,n
t,i,n,g,í,n,$,V,IPFV,AGFOC	n,a,g,p,a,p,a,t,i,n,g,í,n
t,i,n,g,í,n,$,V,IPFV,PFOC	t,i,n,i,t,í,n,g,n,a,n
t,i,n,g,í,n,$,V,PFOC,LGSPEC1	t,i,t,í,n,g,n,a,n
t,i,n,g,í,n,$,V,AGFOC,LGSPEC1	m,a,g,p,a,p,a,t,i,n,g,í,n
t,i,n,g,í,n,$,V,PFV,PFOC	t,i,n,í,n,g,n,a,n
t,i,n,g,í,n,$,V,PFV,AGFOC	n,a,g,p,a,t,i,n,g,í,n
a,r,t,e,$,V,NFIN	a,r,t,e
a,r,t,e,$,V,PFV,AGFOC	u,m,a,r,t,e
a,r,t,e,$,V,PFV,PFOC	i,n,a,r,t,e,h,a,n
a,r,t,e,$,V,IPFV,AGFOC	u,m,a,a,r,t,e
a,r,t,e,$,V,PFOC,LGSPEC1	a,a,r,t,e,h,a,n
a,r,t,e,$,V,AGFOC,LGSPEC1	a,a,r,t,e
a,r,t,e,$,V,IPFV,PFOC	i,n,a,a,r,t,e,h,a,n
k,o,p,y,a,$,V,IPFV,PFOC	k,i,n,o,k,o,p,y,a
k,o,p,y,a,$,V,PFV,PFOC	k,i,n,o,p,y,a
k,o,p,y,a,$,V,PFV,AGFOC	k,u,m,o,p,y,a
k,o,p,y,a,$,V,PFOC,LGSPEC1	k,o,k,o,p,y,a,h,i,n
k,o,p,y,a,$,V,IPFV,AGFOC	k,u,m,o,k,o,p,y,a
k,o,p,y,a,$,V,NFIN	k,o,p,y,a
k,o,p,y,a,$,V,AGFOC,LGSPEC1	k,o,k,o,p,y,a
s,ú,n,o,d,$,V,PFV,PFOC	s,i,n,ú,n,d,a,n
s,ú,n,o,d,$,V,NFIN	s,ú,n,o,d
s,ú,n,o,d,$,V,PFOC,LGSPEC1	s,u,s,ú,n,u,r,i,n
s,ú,n,o,d,$,V,IPFV,PFOC	s,i,n,u,s,ú,n,o,d
s,ú,n,o,d,$,V,PFV,AGFOC	s,u,m,ú,n,o,d
s,ú,n,o,d,$,V,AGFOC,LGSPEC1	s,u,s,ú,n,o,d
s,ú,n,o,d,$,V,IPFV,AGFOC	s,u,m,ú,s,u,n,o,d
t,a,w,a,g,$,V,IPFV,PFOC	t,i,n,a,t,a,w,a,g
t,a,w,a,g,$,V,AGFOC,LGSPEC1	t,a,t,a,w,a,g
t,a,w,a,g,$,V,PFOC,LGSPEC1	t,a,t,a,w,a,g,a,n
t,a,w,a,g,$,V,NFIN	t,a,w,a,g
t,a,w,a,g,$,V,PFV,PFOC	t,i,n,a,w,a,g,a,n
t,a,w,a,g,$,V,PFV,AGFOC	t,u,m,a,w,a,g
t,a,w,a,g,$,V,IPFV,AGFOC	t,u,m,a,t,a,w,a,g
t,a,w,a,g,$,V,IPFV,PFOC	t,i,n,a,t,a,w,a,g,a,n
t,a,w,a,g,$,V,PFV,PFOC	t,i,n,a,w,a,g
s,a,l,ó,$,V,PFV,PFOC	s,i,n,a,l,ó
s,a,l,ó,$,V,NFIN	s,a,l,ó
s,a,l,ó,$,V,IPFV,AGFOC	s,u,m,a,s,a,l,ó
s,a,l,ó,$,V,PFV,AGFOC	s,u,m,a,l,ó
s,a,l,ó,$,V,AGFOC,LGSPEC1	s,a,s,a,l,ó
s,a,l,ó,$,V,IPFV,PFOC	s,i,n,a,s,a,l,ó
s,a,l,ó,$,V,PFOC,LGSPEC1	s,a,s,a,l,ú,h,i,n
a,b,o,t,$,V,PFOC,LGSPEC1	a,a,b,u,t,i,n
a,b,o,t,$,V,NFIN	a,b,o,t
a,b,o,t,$,V,IPFV,AGFOC	n,a,g,-,a,a,b,o,t
a,b,o,t,$,V,PFV,PFOC	i,n,a,b,o,t
a,b,o,t,$,V,PFV,AGFOC	u,m,a,b,o,t
a,b,o,t,$,V,IPFV,PFOC	i,n,a,a,b,u,t,a,n
a,b,o,t,$,V,AGFOC,LGSPEC1	m,a,g,-,a,a,b,o,t
a,b,o,t,$,V,IPFV,PFOC	i,n,a,a,b,o,t
a,b,o,t,$,V,PFV,AGFOC	n,a,g,-,a,b,o,t
a,b,o,t,$,V,AGFOC,LGSPEC1	a,a,b,o,t
a,b,o,t,$,V,PFOC,LGSPEC1	a,a,b,u,t,a,n
d,a,l,i,',$,V,IPFV,PFOC	m,i,n,a,m,a,d,a,l,i,'
d,a,l,i,',$,V,NFIN	d,a,l,i,'
d,a,l,i,',$,V,IPFV,AGFOC	n,a,g,m,a,m,a,d,a,l,i,'
d,a,l,i,',$,V,PFV,AGFOC	n,a,g,m,a,d,a,l,i,'
d,a,l,i,',$,V,PFV,PFOC	m,i,n,a,d,a,l,i,'
d,a,l,i,',$,V,PFOC,LGSPEC1	m,a,m,a,d,a,l,i,i,n
d,a,l,i,',$,V,AGFOC,LGSPEC1	m,a,g,m,a,m,a,d,a,l,i,'
b,a,b,á,',$,V,PFV,PFOC	b,i,n,a,b,á,'
b,a,b,á,',$,V,IPFV,AGFOC	b,u,m,a,b,a,b,á,'
b,a,b,á,',$,V,IPFV,PFOC	b,i,n,a,b,a,b,á,'
b,a,b,á,',$,V,PFOC,LGSPEC1	i,b,a,b,a,b,á,'
b,a,b,á,',$,V,PFV,AGFOC	b,u,m,a,b,á,'
b,a,b,á,',$,V,NFIN	b,a,b,á,'
b,a,b,á,',$,V,AGFOC,LGSPEC1	b,a,b,a,b,á,'
p,ú,n,o,',$,V,NFIN	p,ú,n,o,'
p,ú,n,o,',$,V,IPFV,AGFOC	n,a,p,u,p,ú,n,o,'
p,ú,n,o,',$,V,AGFOC,LGSPEC1	m,a,p,u,p,ú,n,o,'
p,ú,n,o,',$,V,PFV,AGFOC	n,a,p,ú,n,o,'
k,a,m,i,t,$,V,PFOC,LGSPEC1	m,a,k,a,k,a,m,t,a,n
k,a,m,i,t,$,V,IPFV,AGFOC	n,a,k,a,k,a,m,i,t
k,a,m,i,t,$,V,PFV,PFOC	n,a,k,a,m,t,a,n
k,a,m,i,t,$,V,NFIN	k,a,m,i,t
k,a,m,i,t,$,V,AGFOC,LGSPEC1	m,a,k,a,k,a,m,i,t
k,a,m,i,t,$,V,IPFV,PFOC	n,a,k,a,k,a,m,t,a,n
k,a,m,i,t,$,V,PFV,AGFOC	n,a,k,a,m,i,t
u,n,l,a,d,$,V,PFV,AGFOC	u,m,u,n,l,a,d
u,n,l,a,d,$,V,IPFV,AGFOC	u,m,u,u,n,l,a,d
u,n,l,a,d,$,V,IPFV,PFOC	i,n,u,u,n,l,a,d
u,n,l,a,d,$,V,AGFOC,LGSPEC1	u,u,n,l,a,d
u,n,l,a,d,$,V,PFOC,LGSPEC1	u,u,n,l,a,r,i,n
u,n,l,a,d,$,V,NFIN	u,n,l,a,d
u,n,l,a,d,$,V,PFV,PFOC	i,n,u,n,l,a,d
t,a,n,g,g,i,$,V,PFOC,LGSPEC1	t,a,t,a,n,g,g,i,h,a,n
t,a,n,g,g,i,$,V,IPFV,AGFOC	t,a,m,a,t,a,n,g,g,i
t,a,n,g,g,i,$,V,PFV,AGFOC	t,u,m,a,n,g,g,i
t,a,n,g,g,i,$,V,AGFOC,LGSPEC1	t,a,t,a,n,g,g,i
t,a,n,g,g,i,$,V,IPFV,PFOC	t,i,n,a,t,a,n,g,g,i,h,a,n
t,a,n,g,g,i,$,V,NFIN	t,a,n,g,g,i
t,a,n,g,g,i,$,V,PFV,PFOC	t,i,n,a,n,g,g,i,h,a,n
t,r,a,b,a,h,o,$,V,AGFOC,LGSPEC1	m,a,g,t,a,t,r,a,b,a,h,o
t,r,a,b,a,h,o,$,V,PFV,AGFOC	n,a,g,t,r,a,b,a,h,o
t,r,a,b,a,h,o,$,V,NFIN	t,r,a,b,a,h,o
t,r,a,b,a,h,o,$,V,IPFV,PFOC	t,i,n,a,t,r,a,b,a,h,o
t,r,a,b,a,h,o,$,V,PFV,PFOC	t,i,n,r,a,b,a,h,o
t,r,a,b,a,h,o,$,V,IPFV,AGFOC	n,a,g,t,a,t,r,a,b,a,h,o
t,r,a,b,a,h,o,$,V,PFOC,LGSPEC1	t,a,t,r,a,b,a,h,u,i,n
u,l,i,t,$,V,PFV,AGFOC	n,a,g,-,u,l,i,t
u,l,i,t,$,V,NFIN	u,l,i,t
u,l,i,t,$,V,PFOC,LGSPEC1	u,u,l,i,t,i,n
u,l,i,t,$,V,AGFOC,LGSPEC1	m,a,g,-,u,u,l,i,t
u,l,i,t,$,V,PFV,PFOC	i,n,u,l,i,t
u,l,i,t,$,V,IPFV,PFOC	i,n,u,u,l,i,t
u,l,i,t,$,V,IPFV,AGFOC	n,a,g,-,u,u,l,i,t
u,l,i,t,$,V,PFV,AGFOC	u,m,u,l,i,t
u,l,i,t,$,V,IPFV,AGFOC	u,m,u,u,l,i,t
u,l,i,t,$,V,AGFOC,LGSPEC1	u,u,l,i,t
t,a,g,u,y,o,d,$,V,NFIN	t,a,g,u,y,o,d
t,a,g,u,y,o,d,$,V,AGFOC,LGSPEC1	m,a,g,t,a,t,a,g,u,y,o,d
t,a,g,u,y,o,d,$,V,IPFV,PFOC	t,i,n,a,t,a,g,u,y,o,d
t,a,g,u,y,o,d,$,V,PFV,PFOC	t,i,n,a,g,u,y,o,d
t,a,g,u,y,o,d,$,V,PFOC,LGSPEC1	i,t,a,t,a,g,u,y,o,d
t,a,g,u,y,o,d,$,V,IPFV,AGFOC	n,a,g,t,a,t,a,g,u,y,o,d
t,a,g,u,y,o,d,$,V,PFV,AGFOC	n,a,g,t,a,g,u,y,o,d
l,u,n,g,k,o,t,$,V,IPFV,PFOC	i,k,i,n,a,l,u,l,u,n,g,k,o,t
l,u,n,g,k,o,t,$,V,PFV,AGFOC	n,a,l,u,n,g,k,o,t
l,u,n,g,k,o,t,$,V,PFOC,LGSPEC1	i,k,a,l,u,l,u,n,g,k,o,t
l,u,n,g,k,o,t,$,V,PFV,PFOC	i,k,i,n,a,l,u,n,g,k,o,t
l,u,n,g,k,o,t,$,V,NFIN	l,u,n,g,k,o,t
l,u,n,g,k,o,t,$,V,IPFV,AGFOC	n,a,l,u,l,u,n,g,k,o,t
l,u,n,g,k,o,t,$,V,AGFOC,LGSPEC1	m,a,l,u,l,u,n,g,k,o,t
k,a,n,t,a,$,V,NFIN	k,a,n,t,a
k,a,n,t,a,$,V,IPFV,AGFOC	k,u,m,a,k,a,n,t,a
k,a,n,t,a,$,V,AGFOC,LGSPEC1	k,a,k,a,n,t,a
k,a,n,t,a,$,V,IPFV,PFOC	k,i,n,a,k,a,n,t,a
k,a,n,t,a,$,V,PFOC,LGSPEC1	k,a,k,a,n,t,a,h,i,n
k,a,n,t,a,$,V,PFV,PFOC	k,i,n,a,n,t,a
k,a,n,t,a,$,V,PFV,AGFOC	k,u,m,a,n,t,a
b,a,k,a,s,y,o,n,$,V,AGFOC,LGSPEC1	m,a,g,b,a,b,a,k,a,s,y,o,n
b,a,k,a,s,y,o,n,$,V,IPFV,AGFOC	n,a,g,b,a,b,a,k,a,s,y,o,n
b,a,k,a,s,y,o,n,$,V,PFV,AGFOC	n,a,g,b,a,k,a,s,y,o,n
b,a,k,a,s,y,o,n,$,V,PFV,PFOC	b,i,n,a,k,a,s,y,u,n,a,n
b,a,k,a,s,y,o,n,$,V,PFOC,LGSPEC1	b,a,b,a,k,a,s,y,u,n,a,n
b,a,k,a,s,y,o,n,$,V,NFIN	b,a,k,a,s,y,o,n
b,a,k,a,s,y,o,n,$,V,IPFV,PFOC	b,i,n,a,b,a,k,a,s,y,u,n,a,n
i,l,a,w,$,V,PFV,AGFOC	u,m,i,l,a,w
i,l,a,w,$,V,IPFV,AGFOC	u,m,i,i,l,a,w
i,l,a,w,$,V,PFV,PFOC	i,n,i,l,a,w,a,n
i,l,a,w,$,V,IPFV,PFOC	i,n,i,i,l,a,w,a,n
i,l,a,w,$,V,NFIN	i,l,a,w
i,l,a,w,$,V,AGFOC,LGSPEC1	i,i,l,a,w
i,l,a,w,$,V,PFOC,LGSPEC1	i,i,l,a,w,a,n
y,a,k,a,p,$,V,PFOC,LGSPEC1	y,a,y,a,k,a,p,i,n
y,a,k,a,p,$,V,NFIN	y,a,k,a,p
y,a,k,a,p,$,V,PFV,AGFOC	y,u,m,a,k,a,p
y,a,k,a,p,$,V,IPFV,PFOC	n,i,y,a,y,a,k,a,p
y,a,k,a,p,$,V,AGFOC,LGSPEC1	y,a,y,a,k,a,p
y,a,k,a,p,$,V,PFV,PFOC	n,i,y,a,k,a,p
y,a,k,a,p,$,V,IPFV,AGFOC	y,u,m,a,y,a,k,a,p
b,a,n,t,a,y,$,V,IPFV,AGFOC	n,a,g,b,a,b,a,n,t,a,y
b,a,n,t,a,y,$,V,AGFOC,LGSPEC1	m,a,g,b,a,b,a,n,t,a,y
b,a,n,t,a,y,$,V,NFIN	b,a,n,t,a,y
b,a,n,t,a,y,$,V,PFV,AGFOC	n,a,g,b,a,n,t,a,y
b,a,n,t,a,y,$,V,PFOC,LGSPEC1	b,a,b,a,n,t,a,y,a,n
b,a,n,t,a,y,$,V,IPFV,PFOC	b,i,n,a,b,a,n,t,a,y,a,n
b,a,n,t,a,y,$,V,PFV,PFOC	b,i,n,a,n,t,a,y,a,n
h,u,g,a,s,$,V,PFV,PFOC	h,i,n,u,g,a,s,a,n
h,u,g,a,s,$,V,AGFOC,LGSPEC1	m,a,g,h,u,h,u,g,a,s
h,u,g,a,s,$,V,IPFV,AGFOC	n,a,g,h,u,h,u,g,a,s
h,u,g,a,s,$,V,PFV,AGFOC	n,a,g,h,u,g,a,s
h,u,g,a,s,$,V,NFIN	h,u,g,a,s
h,u,g,a,s,$,V,PFOC,LGSPEC1	h,u,h,u,g,a,s,a,n
h,u,g,a,s,$,V,IPFV,PFOC	h,i,n,u,h,u,g,a,s,a,n
d,a,m,p,o,t,$,V,PFV,AGFOC	d,u,m,a,m,p,o,t
d,a,m,p,o,t,$,V,AGFOC,LGSPEC1	d,a,d,a,m,p,o,t
d,a,m,p,o,t,$,V,IPFV,AGFOC	d,u,m,a,d,a,m,p,o,t
d,a,m,p,o,t,$,V,PFV,PFOC	d,i,n,a,m,p,o,t
d,a,m,p,o,t,$,V,NFIN	d,a,m,p,o,t
d,a,m,p,o,t,$,V,PFOC,LGSPEC1	d,a,d,a,m,p,u,t,i,n
d,a,m,p,o,t,$,V,IPFV,PFOC	d,i,n,a,d,a,m,p,o,t
s,u,l,o,n,g,$,V,IPFV,AGFOC	s,u,m,u,s,u,l,o,n,g
s,u,l,o,n,g,$,V,IPFV,PFOC	s,i,n,u,s,u,l,o,n,g
s,u,l,o,n,g,$,V,PFV,PFOC	s,i,n,u,l,o,n,g
s,u,l,o,n,g,$,V,PFV,AGFOC	s,u,m,u,l,o,n,g
s,u,l,o,n,g,$,V,PFOC,LGSPEC1	s,u,s,u,l,u,n,g,i,n
s,u,l,o,n,g,$,V,AGFOC,LGSPEC1	s,u,s,u,l,o,n,g
s,u,l,o,n,g,$,V,NFIN	s,u,l,o,n,g
t,u,l,o,g,$,V,NFIN	t,u,l,o,g
t,u,l,o,g,$,V,PFV,PFOC	t,i,n,u,l,u,g,a,n
t,u,l,o,g,$,V,IPFV,PFOC	t,i,n,u,t,u,l,u,g,a,n
t,u,l,o,g,$,V,PFOC,LGSPEC1	t,u,t,u,l,u,g,a,n
t,u,l,o,g,$,V,IPFV,AGFOC	n,a,t,u,t,u,l,o,g
t,u,l,o,g,$,V,PFV,AGFOC	n,a,t,u,l,o,g
t,u,l,o,g,$,V,AGFOC,LGSPEC1	m,a,t,u,t,u,l,o,g
t,a,w,a,$,V,AGFOC,LGSPEC1	t,a,t,a,w,a
t,a,w,a,$,V,PFV,PFOC	t,i,n,a,w,a,n,a,n
t,a,w,a,$,V,PFV,AGFOC	t,u,m,a,w,a
t,a,w,a,$,V,IPFV,PFOC	t,i,n,a,t,a,w,a,n,a,n
t,a,w,a,$,V,IPFV,AGFOC	t,u,m,a,t,a,w,a
t,a,w,a,$,V,NFIN	t,a,w,a
t,a,w,a,$,V,PFOC,LGSPEC1	t,a,t,a,w,a,n,a,n
p,a,s,y,a,l,$,V,IPFV,AGFOC	n,a,m,a,m,a,s,y,a,l
p,a,s,y,a,l,$,V,PFV,AGFOC	n,a,m,a,s,y,a,l
p,a,s,y,a,l,$,V,AGFOC,LGSPEC1	m,a,m,a,m,a,s,y,a,l
p,a,s,y,a,l,$,V,PFOC,LGSPEC1	p,a,p,a,s,y,a,l,a,n
p,a,s,y,a,l,$,V,NFIN	p,a,s,y,a,l
p,a,s,y,a,l,$,V,IPFV,PFOC	p,i,n,a,p,a,s,y,a,l,a,n
p,a,s,y,a,l,$,V,PFV,PFOC	p,i,n,a,s,y,a,l,a,n
s,a,m,a,$,V,AGFOC,LGSPEC1	s,a,s,a,m,a
s,a,m,a,$,V,PFV,PFOC	s,i,n,a,m,a,h,a,n
s,a,m,a,$,V,PFV,AGFOC	s,u,m,a,m,a
s,a,m,a,$,V,IPFV,AGFOC	s,u,m,a,s,a,m,a
s,a,m,a,$,V,PFOC,LGSPEC1	s,a,s,a,m,a,h,a,n
s,a,m,a,$,V,IPFV,PFOC	s,i,n,a,s,a,m,a,h,a,n
s,a,m,a,$,V,NFIN	s,a,m,a